000022222222222222222222222200
000021111111111111111111111200
000021333333333333333333331200
000021322222222222222222231200
000021333333333320000000231200
000021111111111320000000231200
000022222222221320000000231200
000000000000021320000000231200
022222220000021320000000231200
111111120000021320000000231200
333333120000021320000000231200
022223120000021320000000231200
000023120000021320000000231200
000023120000021320000000231200
000023120000021320000000444400
000023122222221320000000444400
000023111111111320000000444400
000023333333333320000000444400
000022222222222220000000000000
000000000000000000000000000000