000022222222222222222222222200
000021111111111111111111111200
000021111111111111111111111200
000021122222222222222222211200
000021111111111120000000211200
000021111111111120000000211200
000022222222221120000000211200
000000000000021120000000211200
022222220000021120000000211200
111111120000021120000000211200
111111120000021120000000211200
022221120000021120000000211200
000021120000021120000000211200
000021120000021120000000211200
000021120000021120000000444400
000021122222221120000000444400
000021111111111120000000444400
000021111111111120000000444400
000022222222222220000000000000
000000000000000000000000000000